NO  ./textures/purplestone.xpm
SO    ./textures/wall.xpm
WE     ./textures/purplestone.xpm
EA     ./textures/purplestone.xpm
F  220,100,0
C   225,30,0

11111111111111
10000000111111
10000000000001
10000000000001
10000000000001
10000000000001
10000000000001
1000000N000001
10000000000001
10000000000001
10000000000001
10000000000001
10000000000001
10000000000001
11111111111111
