NO  ./textures/purplestone.xpm
SO    ./textures/bluestone.xpm
WE     ./textures/mossy.xpm
EA     ./textures/eagle.xpm
F  178,132,190
C  124,185,232

11111111111111
11100000000111
10000000000001
11011000000001
1100000E111101
10000000000011
10000000000001
10000000000001
11000000000001
10000000000001
10000000000001
10000000000001
11111111111111
