NO  ./textures/purplestone.xpm
SO    ./textures/bluestone.xpm
WE     ./textures/mossy.xpm
EA     ./textures/eagle.xpm
F  220,100,0
C   225,30,0

11111111111111
11100000000111
10000000000001
11000000000001
11000000000001
10000000000011
1000000N000001
10000000000001
11000000000001
10000000000001
10000000000001
10000000000001
11111111111111
