


SO " ./path_to_   the  _south   _texture"




NO          ./path_to_the_north_texture"


WE  "./path_to_        the_west_texture"







EA ".   /   path   _to   _the_east_   texture"

C    253,30,211

F 255,100,3

11111111111111111 11111111
1000000000110000000000001
1011000001110000000000001
1001000000000000000000111
100000000011000001110111111111111
11110111111111011100000010001
11110111111111011101010010001
110000001101010111000000100001
1000000000000000110000001000001
100000000000000011010100100011
11000001110101011111011110N0111
11110111 1110101 101111010001
11111111 1111111 111111111111
111111111000000000011111111111111111
1111100000000000000000000111100000011
11111111111111111111111111111111111
