NO  "     ./path_to_the_north_    texture      xx  xx"
SO ./path_to_the_south_texture
WE     "./path_to_the_west_texture"
EA ./path_to_the_east_texture
F  220,100,0
C   225,30,0

11111111111111111 11111111
1000000000110000000000001
1011000001110000000000001
1001000000000000000000111
100000000011000001110111111111111
11110111111111011100000010001
11110111111111011101010010001
110000001101010111000000100001
10000000000000001100W0001000001
100000000000000011010100100011
1100000111010101111101111000111
11110111 1110101 101111010001
11111111 1111111 111111111111
1111111110000000000001111111111111111
1111100000000000000000000111100000011
11111111111111111111111111111111111
