NO ./textures/purplestone.xpm
SO    ./textures/bluestone.xpm
WE     ./textures/mossy.xpm
EA     "./textures/eagle.xpm"
F  178,132,190
C  124,185,232

11111111111111
11100000000111
100000000000001
11011000000001
11000000111101
10000000000011
1000000000001
100000000000011
110000N0000001
10000000000001
10000000000001
10000000000001
11111111111111
