NO  ./path_to_the_north_texture
SO    ./path_to_the_south_texture
WE     ./path_to_the_west_texture
EA     ./path_to_the_east_texture
F  220, 100,0
C   225,30,0

11111111111111111111111111
1000000000110000000000001
1011000001110000000000001
1001000000000000000000111
100000000011000001110111111111111
11110111111111011100000010001
11110111111111011101010010001
110000001101010111000000100001
1000000000000000110000001000001
10000000000S0000011010100100011
1100000111010101111101111000111
11110111 1110101 101111010001
11111111 1111111 111111111111
111111111000000000000111111111111111
111110000000000000000000011110000111
111111111111111111111111111111111
